111111111111111111111111111
100000000000000000000000001
100000000000000000000000001
100000000000111001111101001
10000000000111000111C101001
100000000011100001100101001
1000000001110000010001C1001
100000001110000000000111001
100000011100000000001110001
100000111000000000011100001
100001110000000000111000001
100011100000000001110000001
100111111111110001C10001001
1001E0000000010001010011001
10011111111101000101C111001
100000000001010001011111001
100000000001010000000000001
100000000001010000000000001
100000000001P10000000000001
100000000000000000000000001
100000000000000000000000001
111111111111111111111111111