11111111111111111111111111111
1C00000000000000101C001000001
11111100001000101010000000001
10000000001000100000000000001
10010001111000111000000000001
1P0100000010000C1100000000001
10000000000000000001111110C01
10000011111111111C00000000001
10011110000000000011110000001
10000C11000000000000E1C111111
11111111111111111111111111111