111111111111111111
100110010001100101
100010111101100101
1E101000101C001P01
110000011000001001
101000000000010111
111111111111111111