11111111111111111111111111111111111111111
1P000000C00000000000000000000000000000011
11111111111C11111100111111100001111111011
11111C111111110000000000000000000C0000001
100000000000110000C00111111111111111110C1
10000000000000000111000000000000000000011
10000000011111111111111111111111111111111
1000000001C100011111111110000000000001001
10110000010100000000000000000000000011111
10010000000000000000000000000000001111111
11C10000000111111111111111111100E0000C111
11111111111111111111111111111111111111111
