111111111111111111
100101C000C0000011
1000001111000C0001
1E001000C0011100C1
100011100000110001
10000C1110000P0001
111111111111111111