111111111111111111
100110011001100001
100010111101100C01
1E1010000001100001
100000111000000101
1P1000001010010011
111111111111111111