111111111111111111
100110010000000101
110010111101100101
10E0100010001000P1
11000001100C011U01
101000000000010111
111111111111111111