111111111111111111
100110010000000101
110010111101100101
1E101000100C100P01
110000011000011001
101000000000010111
111111111111111111