111111111111111111
1P0101C000C0000011
1000001111000C0001
1E001000C0000000C1
100000000000000001
10000C111000000001
111111111111111111