11111111111111111111111111111
1C00000000000000101C00E000001
11111100001000101010000000001
10000000001000100000000000001
10010001111000111000000000001
1P0100000010000C1100000000001
11111111111111111111111111111