111111111111111111
100110010001100101
110010111101100101
1E001000101C100P01
110000011000001001
1010000000000101111111
111111111111111111