111111111111111111111111
1P0001000000001111000001
100000111100001111000001
100010000001100000000001
10001110000C110000000001
100000111100000111100001
100000111100000111100001
1000001111000011110000E1
111111111111111111111111
