111111111111111111
100110010001100101
110010111101100101
1E101000101C100P01
110000011000001001
101000000000010111
111111111111111111