111111111111111111
100101000000000011
100000111100000001
1E001000C001110001
100011100000110001
10000C1110000P0001
111111111111111111