11111111111111111111111111111111111111111
10010100000000000000000000000000000000011
10000011110000000000000000000000000000001
1E001000C00111000000000011111111111000001
100011100000110000000000000000000111110C1
10000C1110000P000000000000000000000000111
10000000011111111111000000000000000000001
1000000001C100011111111110000000000001001
10000000000100000000000000000000000010101
10000000000000000000000000000000000011101
100000000001000000000000000000000000001C1
11111111111111111111111111111111111111111
