111111111111111111
100101000000100011
11C000111100100001
100010000000100001
110000100000000001
10001000000E100P01
111111111111111111