1111111111111
1P00100C000C1
1000000111001
1E001100C00X1
1111111111111