111111111111111111
100100C000C0000P01
1000000111000C0001
1E001100C00X0000C1
111111111111111111